Mapa x=10, y=10
#####*#***
########*#
#*######**
#*#*######
#***#####*
##*####*##
**##*#*##*
##*#*#####
##*####*#*
######*###
